EA textures/EA.xpm
NO textures/SO.xpm
SO textures/WE.xpm
WE textures/NO.xpm
F 81,41,28
C 53,168,9

        1111111111111111111111111
        100000000011000000000001
        1011000001110000000000001
        1001000000000000000000001
111111111011000001110000000000001
100000000011000001110111111111111
11110111111111011100000010001
11110111111111011101010010001
11000000110101011100000010001
10000000000000001100000010001
1000N000000000001101010010001
11000001110101011111011110011
11110111 1110101 101111010001
11111111 1111111 111111111111