F 		81,41,28
C 		53,168,2
WE 		textures/NO.xpm
SO 		textures/WE.xpm
NO 		textures/SO.xpm
EA 		textures/EA.xpm

        1111111111111111111111111
        100000000011000000000001111
        10110000011100000000000110 1
        100100000000000000000000111
111111111011000001110000000000001
100000000011000001110111111111111
1111011111111101110000001
1111011111111101110101001
1100000011010101110000001
1000W00000000000110000001
1000000000000000110101001
1100000101010111111101111
1111011101110010000111101
1111111111111111111111111