F       81,41,28
C       255,0,0
WE      textures/NO.xpm
SO      textures/WE.xpm
NO      textures/SO.xpm
EA      textures/EA.xpm

        1111111111111111111111111
        1000000000110000000000001
        1011000001110000000000N01
        1001000000000000000000001
111111111011000001110000000000001
100000000011000001110111111111111
11110111111111011100000010001
11110111111111011101010010001
11000000110101011100100010001
10010000000000001100000010001
100000000000000001101010010001
1100000111010101111101111000111
11111111111111111111111111111111