F       81,41,28
C       53,168,2
WE      textures/NO.xpm
SO      textures/WE.xpm
NO      textures/SO.xpm
EA      textures/EA.xpm

        11111111111111111111111111
        10000000001100000010000111
        10110000011100000101000001
        10010000000000000010000011
1111111110110000011100000000000011
1000000000110000011101111111111111
1111011111111101110000001
1111011111111101110101001
1100000011010101110000001
1000000000000000110000001
1000000000000000110101001
11W0000101010111111101111
1111111101110000000111101
1111111111111111111111111