EA textures/EA.xpm
NO textures/SO.xpm
SO textures/WE.xpm
WE textures/NO.xpm
F 81,41,28
C 53,168,9

        1111111111111111111111111
        10000000001100000000001
        10110000011100000000000101
        10010000000000000000000101
1111111110110000011100000000000101
100000000011000001110111111111111
11110111111111011100000010001
11110111111111011101010010001
11000000110101011100000010001
1000W000000000001100000010001
10000000000000001101010000001
11000001010101011111011110011
11110111011101000001111010001
111111111111111111111111111111111