F       120,40,31 
C       174,214,241
WE      textures/NO.xpm
SO      textures/WE.xpm
NO      textures/SO.xpm
EA      textures/EA.xpm

        1111111111111111111111111
        1000000000110101000000001
        1011000001110010000001W11
        1001000000000101000000101
111111111011000001110000000000001
100000000011000001110111111111111
111101111111110111000000100010011
111101111111110111010100100010011
110000001101010111001000100010011
100100000000000011000000100010011
100000000000000001101010010001011
110000011101010111110111100011111
111111111111111111111111111111111