F 		81,41,28
C 		53,168,9		 
WE 		textures/NO.xpm
SO 		textures/WE.xpm
NO 		textures/SO.xpm
EA 		textures/EA.xpm

        1111111111111111111111111111
        1000000000110000000000011
        1011000001110000000000011
        10010000000000000000000011
11111111101100000111000000000000101
1000000000110000011101111111111111
11110111111111011100000010001
111101111111110111010100100011
1100000011010101110000001000101
1000W0000000000011000000100011
1000000000000000110101000000101
110000010101011111110111100111
11110111011100100001111010001
111111111111111111111111111111111