F       81,41,28
C       53,168,2
WE      textures/NO.xpm
SO      textures/WE.xpm
NO      textures/SO.xpm
EA      textures/EA.xpm

        1111111111111111111111111
        1000000000110000001000011
        1011000001110000010100001
        1001000000000000001000001111
1111111111110100000011100000E0000001
111100000000010000001110111111111111
1111111011111101101110000001
1111111011111101101110101001
1111100000011101101110000001
1111110000000000000110000001
1111010000000010000110101001
1111110000101010111111101111
1111111111101110000000111101
1111111111111111111111111111