F       81,41,28
C       53,168,2
WE      textures/NO.xpm
SO      textures/WE.xpm
NO      textures/SO.xpm
EA      textures/EA.xpm

111111111111111111111
100000000000000000001
101111111111111111101
101011111111111110101
101100000000000001101
101100000000000001101
101100000000000001101
101100000000000001101
101100000000000001101
101100000000000001101
101100000N00000001101
101100000000000001101
101100000000000001101
101100000000000001101
101100000000000001101
101011111111111110101
101111111111111111101
101  11   1   1   101
1011 1111 111 111 101
1011 11   1   111 101
1011 1111 111 111 101
101   1   1   111 101
101111111111111111101
100000000000000000001
111111111111111111111