F       81,41,28
C       53,168,2
WE      textures/NO.xpm
SO      textures/WE.xpm
NO      textures/SO.xpm
EA      textures/EA.xpm





111111111111111
100000100000001
1000001111111111111111111
10000011000000000000010001111111111111
10000000000000000000000000000000000001
10000011000000000000010001111111111101
11101111111011111111110001         101
110000110000001      10001         101
100000010000001      10001         101
100000010000001      10001         101
10000000000000111111111011111111111101
10000001000000100000000000000000001101
100000010000001000000000000000000011011
110000110000001001100000000000110010001
111101111111111001000000000000010010001
   101        1000000000000000000010001
   101        1000000000100000000010001
   101111111111000000001010000000000001
   100000000000000000000100000000010001
   11111111111100000000000S000000010001
              1001000000000000010010001
              1001100000000000110010001
              1000000000000000000010001
              1000000000000000000010001
              1111111111111111111111111