F       81,41,28
C       53,168,2
WE      textures/NO.xpm
SO      textures/WE.xpm
NO      textures/SO.xpm
EA      textures/EA.xpm




111111111111111
100000100000001
1000011111111111111111111
10000011000000000000010001
10000010000000000000000001
10000011000000000000010001
11101111111011111111110001
110000110000001      10001
100000010000001      10001
100000010000001      10001
10000000000000111111111011111111111
10000001000000100000000000000000001
100000010000001000000000000000000011111
110000110000001001110000000000110010001
111111111111111001000000000000010010001
              1000000000100000000010001
              1000000001000000000010001
              1000000000000000000000001
              1000000000000000000010001
              100000000000N000000010001
              1001000000000000010010001
              1001100000000000110010001
              1000000000000000000010001
              1000000000000000000010001
              1111111111111111111111111